p	ー
~	〜
.	．
,	，
[	「
]	」
@j	ゔぁ
@;	ゔぃ
@h	ゔ
@o	ゔぇ
@l	ゔぉ
@aj	ゔゃ
@a;	ゔぃ
@ah	ゔゅ
@ao	ゔぇ
@al	ゔょ
@@	っ	@
yy	っ	y
ss	っ	s
bb	っ	b
gg	っ	g
rr	っ	r
ff	っ	f
vv	っ	v
ee	っ	e
xx	っ	x
tt	っ	t
cc	っ	c
aa	っ	a
ww	っ	w
zz	っ	z
zzz	z	zz
saj	きゃ
sa;	きぃ
sah	きゅ
sao	きぇ
sal	きょ
baj	ぎゃ
ba;	ぎぃ
bah	ぎゅ
bao	ぎぇ
bal	ぎょ
gaj	しゃ
ga;	しぃ
gah	しゅ
gao	しぇ
gal	しょ
gej	しゃ
ge;	し
geh	しゅ
geo	しぇ
gel	しょ
raj	じゃ
ra;	じぃ
rah	じゅ
rao	じぇ
ral	じょ
faj	ちゃ
fa;	ちぃ
fah	ちゅ
fao	ちぇ
fal	ちょ
vaj	ぢゃ
va;	ぢぃ
vah	ぢゅ
vao	ぢぇ
val	ぢょ
fgj	つぁ
fg;	つぃ
fgo	つぇ
fgl	つぉ
fej	てゃ
fe;	てぃ
feh	てゅ
feo	てぇ
fel	てょ
vej	でゃ
ve;	でぃ
veh	でゅ
veo	でぇ
vel	でょ
fzj	とぁ
fz;	とぃ
fzh	とぅ
fzo	とぇ
fzl	とぉ
vzj	どぁ
vz;	どぃ
vzh	どぅ
vzo	どぇ
vzl	どぉ
daj	にゃ
da;	にぃ
dah	にゅ
dao	にぇ
dal	にょ
eaj	ひゃ
ea;	ひぃ
eah	ひゅ
eao	ひぇ
eal	ひょ
xaj	びゃ
xa;	びぃ
xah	びゅ
xao	びぇ
xal	びょ
taj	ぴゃ
ta;	ぴぃ
tah	ぴゅ
tao	ぴぇ
tal	ぴょ
ezj	ふぁ
ez;	ふぃ
ezo	ふぇ
ezl	ふぉ
ezah	ふゅ
caj	みゃ
ca;	みぃ
cah	みゅ
cao	みぇ
cal	みょ
waj	りゃ
wa;	りぃ
wah	りゅ
wao	りぇ
wal	りょ
dd	ん
d	ん
j	あ
;	い
h	う
zh	う
o	え
l	お
yj	ぁ
y;	ぃ
yh	ぅ
yo	ぇ
yl	ぉ
ya;	ぃ
yao	ぇ
ao	いぇ
sj	か
s;	き
sh	く
so	け
sl	こ
ysj	ヵ
yso	ヶ
bj	が
b;	ぎ
bh	ぐ
bo	げ
bl	ご
gj	さ
g;	し
gh	す
go	せ
gl	そ
szj	くぁ
sz;	くぃ
szo	くぇ
szl	くぉ
bzj	ぐぁ
rj	ざ
r;	じ
rh	ず
ro	ぜ
rl	ぞ
fj	た
f;	ち
fh	つ
fgh	つ
fo	て
fl	と
vj	だ
v;	ぢ
vh	づ
vo	で
vl	ど
yfh	っ
yfgh	っ
dj	な
d;	に
dh	ぬ
do	ね
dl	の
ej	は
e;	ひ
eh	ふ
eo	へ
el	ほ
xj	ば
x;	び
xh	ぶ
xo	べ
xl	ぼ
tj	ぱ
t;	ぴ
th	ぷ
to	ぺ
tl	ぽ
cj	ま
c;	み
ch	む
co	め
cl	も
yaj	ゃ
aj	や
za;	ゐ
yah	ゅ
ah	ゆ
zao	ゑ
yal	ょ
al	よ
wj	ら
w;	り
wh	る
wo	れ
wl	ろ
yzj	ゎ
zj	わ
z;	うぃ
zo	うぇ
zl	を
zej	うぁ
ze;	うぃ
zeh	う
zeo	うぇ
zel	うぉ
